78,78,78,78,78,78,78,78,78,78
78, 0, 1, 2, 3, 4, 5,78,78,78
78,10,11,12,13,14,15,78,78,78
78,20,21,22,23,24,25,78,78,78
78,30,31,32,33,34,35,78,78,78
78,40,41,42,43,44,45,78,78,78
78,78,78,78,78,78,78,78,78,78
78,78,78,78,78,78,78,78,78,78
